**********
*P    *  *
*        *
*        *
*        *
*        *
*        *
*        *
*       G*
**********